11111111111111111111
1000000c000000000001
10000000000e00000001
10000001010000000001
1000000000000e000001
10000000p00000000001
11111111111111111111