11111111111111111111111111111111111111111111111111111111111
1P000100100000010011110000000000000000000000111111111111111
1000000000E0000C0001110000000000000000000000111111111111111
1000000000E0000C0001110000000000000000000000111111111111111
1000000000E0000C0001110000000000000000000000111111111111111
1000000000E0000C0001110000000000000000000000111111111111111
1000000000E0000C0001110000000000000000000000111111111111111
1000000000E0000C0001110000000000000000000000111111101111111
1000000000E0000C00011100000000000000000000001111111P1111111
1000000000E0000C0001110000000000000000000000111111111111111
1000000000E0000C0001110000000000000000000000111111111111111
1000000000E0000C0001110000000000000000000000111111111111111
1000000000E0000C0001110000000000000000000000111111111111111
1000000000E0000C0001110000000000000000000000111111111111111
1000000000E0000C0001110000000000000000000000111111111111111
1000000000E0000C0001110000000000000000000000111111111111111
1000000000E0000C0001110000000000000000000000111111111111111
1000000000E0000C0001110000000000000000000000111111111111111
1000000000E0000C0001110000000000000000000000111111111111111
11111111111111111111111111111111111111111111111111111111111