11111111111111111111111111111111111111111111111111111111111
1P0010P0100000010011110000000000000000000000111111111111111
1000000000E0000C0001110000000000000000000000111111111111111
1000000000E0000C0001110000000000000000000000111111111111111
1000000000E0000C0001110000000000000000000000111111111111111
1000000000E0000C0001110000000000000000000000111111111111111
1000000000E0000C0001110000000000000000000000111111111111111
1000000000E0000C0001110000000000000000000000111111111111111
1000000000E0000C0001110000000000000000000000111111111111111
1000000000E0000C0001110000000000000000000000111111111111111
1000000000E0000C0001110000000000000000000000111111111111111
1000000000E0000C0001110000000000000000000000111111111111111
1000000000E0000C0001110000000000000000000000111111111111111
1000000000E0000C0001110000000000000000000000111111111111111
1000000000E0000C0001110000000000000000000000111111111111111
1000000000E0000C0001110000000000000000000000111111111111111
1000000000E0000C0001110000000000000000000000111111111111111
1000000000E0000C0001110000000000000000000000111111111111111
1000000000E0000C0001110000000000000000000000111111111111111
11111111111111111111111111111111111111111111111111111111111